ANTWERP	BE-VAN
ANTWERP PROVINCE	BE-VAN
ANTWERPEN	BE-VAN
ANTWERPEN PROVINCE	BE-VAN
ANTWERPEN PROVINZ	BE-VAN
ANVERS	BE-VAN
PROVINCE DANVERS	BE-VAN
PROVINCE OF ANTWERP	BE-VAN
PROVINCIE ANTWERPEN	BE-VAN
PROVINZ ANTWERPEN	BE-VAN

EAST FLANDERS	BE-VOV
EASTFLANDERS	BE-VOV
FLANDRE ORIENTALE	BE-VOV
FLANDREORIENTALE	BE-VOV
OOST VLAANDEREN	BE-VOV
OOSTVLAANDEREN	BE-VOV
OST FLANDERN	BE-VOV
OSTFLANDERN	BE-VOV
PROVINCE DE FLANDRE ORIENTALE	BE-VOV
PROVINCE DE FLANDREORIENTALE	BE-VOV
PROVINCE OF EAST FLANDERS	BE-VOV
PROVINCE OF EASTFLANDERS	BE-VOV
PROVINCIE OOST VLAANDEREN	BE-VOV
PROVINCIE OOSTVLAANDEREN	BE-VOV
PROVINZ OSTFLANDERN	BE-VOV

BRABANT FLAMAND	BE-VBR
FLAMISCH BRABANT	BE-VBR
FLAMISCHBRABANT	BE-VBR
FLEMISH BRABANT	BE-VBR
FLEMISHBRABANT	BE-VBR
PROVINCE DE BRABANT FLAMAND	BE-VBR
PROVINCE DE BRABANTFLAMAND	BE-VBR
PROVINCE DU BRABANT FLAMAND	BE-VBR
PROVINCE DU BRABANTFLAMAND	BE-VBR
PROVINCE OF FLEMISH BRABANT	BE-VBR
PROVINCE OF FLEMISHBRABANT	BE-VBR
PROVINCIE VLAAMS BRABANT	BE-VBR
PROVINCIE VLAAMSBRABANT	BE-VBR
PROVINZ FLAMISCH BRABANT	BE-VBR
PROVINZ FLAMISCHBRABANT	BE-VBR
VLAAMS BRABANT	BE-VBR
VLAAMSBRABANT	BE-VBR

HAINAUT	BE-WHT
HAINAUT	BE-WHT
HENEGAUWEN	BE-WHT
HENEGOUWEN	BE-WHT
HENNEGAU	BE-WHT
PROVINCE DE HAINAUT	BE-WHT
PROVINCE DHAINAUT	BE-WHT
PROVINCE DU HAINAUT	BE-WHT
PROVINCE OF HAINAULT	BE-WHT
PROVINCE OF HAINAUT	BE-WHT
PROVINCIE HENEGOUWEN	BE-WHT
PROVINZ HAINAUT	BE-WHT
PROVINZ HENNEGAU	BE-WHT

BELGIAN LIMBURG	BE-VLI
BELGISCH LIMBURG	BE-VLI
BELGISCHE LIMBURG	BE-VLI
FLEMISH LIMBURG	BE-VLI
LIMBOURG	BE-VLI
LIMBOURG BELGE	BE-VLI
LIMBURG	BE-VLI
PROVINCE DE LIMBOURG	BE-VLI
PROVINCE OF LIMBURG	BE-VLI
PROVINCIE LIMBURG	BE-VLI
PROVINZ LIMBURG	BE-VLI
VLAAMS LIMBURG	BE-VLI
WEST LIMBURG	BE-VLI

LIEGE	BE-WLG
LIEGE PROVINCE	BE-WLG
LUIK	BE-WLG
LUTTICH	BE-WLG
PROVINCE DE LIEGE	BE-WLG
PROVINCE OF LIEGE	BE-WLG
PROVINCIE LUIK	BE-WLG
PROVINZ LIEGE	BE-WLG
PROVINZ LUTTICH	BE-WLG

BELGIAN LUXEMBOURG	BE-WLX
BELGISCH LUXEMBURG	BE-WLX
LUXEMBOURG	BE-WLX
LUXEMBOURG BELGE	BE-WLX
LUXEMBOURG PROVINCE	BE-WLX
LUXEMBURG	BE-WLX
PROVINCE DE LUXEMBOURG	BE-WLX
PROVINCE DU LUXEMBOURG	BE-WLX
PROVINCE OF LUXEMBOURG	BE-WLX
PROVINCIE LUXEMBURG	BE-WLX
PROVINZ LUXEMBURG	BE-WLX

NAMEN	BE-WNA
NAMUR	BE-WNA
NAMUR PROVINCE	BE-WNA
PROVINCE DE NAMUR	BE-WNA
PROVINCE OF NAMUR	BE-WNA
PROVINCIE NAMEN	BE-WNA
PROVINCIE NAMUR	BE-WNA
PROVINZ NAMUR	BE-WMA

BRABANT WALLON	BE-WBR
BRABANTWALLON	BE-WBR
PROVINCE DE BRABANT WALLON	BE-WBR
PROVINCE DE BRABANTWALLON	BE-WBR
PROVINCE DU BRABANT WALLON	BE-WBR
PROVINCE DU BRABANTWALLON	BE-WBR
PROVINCE OF WALLOON BRABANT	BE-WBR
PROVINCIE WAALS BRABANT	BE-WBR
PROVINCIE WAALSBRABANT	BE-WBR
PROVINZ WALLONISCH BRABANT	BE-WBR
PROVINZ WALLONISCHBRABANT	BE-WBR
WAALS BRABANT	BE-WBR
WAALSBRABANT	BE-WBR
WALLONISCH BRABANT	BE-WBR
WALLONISCHBRABANT	BE-WBR
WALLOON BRABANT	BE-WBR
WALLOONBRABANT	BE-WBR
WALOON BRABANT	BE-WBR
WALOONBRABANT	BE-WBR

FLANDRE OCCIDENTALE	BE-VWV
FLANDREOCCIDENTALE	BE-VWV
PROVINCE DE FLANDERE OCCIDENTALE	BE-VWV
PROVINCE DE FLANDREOCCIDENTALE	BE-VWV
PROVINCE OF WEST FLANDERS	BE-VWV
PROVINCE OF WESTFLANDERS	BE-VWV
PROVINCIE WEST VLAANDEREN	BE-VWV
PROVINCIE WESTVLAANDEREN	BE-VWV
PROVINZ WESTFLANDERN	BE-VWV
WEST FLANDERS	BE-VWV
WEST VLAANDEREN	BE-VWV
WESTFLANDERN	BE-VWV
WESTFLANDERS	BE-VWV
WESTVLAANDEREN	BE-VWV

BRUESSEL	BE-BRU
BRUESSELS	BE-BRU
BRUSELAS	BE-BRU
BRUSELLS	BE-BRU
BRUSELS	BE-BRU
BRUSSEL	BE-BRU
BRUSSELIAN	BE-BRU
BRUSSELLS	BE-BRU
BRUSSELS	BE-BRU
BRUSSELS CAPITAL	BE-BRU
BRUSSELS CAPITAL REGION	BE-BRU
BRUSSELS CAPITALREGION	BE-BRU
BRUSSELS GEWEST	BE-BRU
BRUSSELS HOOFDSTEDELIJK GEWEST	BE-BRU
BRUSSELS REGION	BE-BRU
BRUSSELSCAPITAL	BE-BRU
BRUSSELSCAPITAL REGION	BE-BRU
BRUSSELSE REGION	BE-BRU
BRUSSLES	BE-BRU
BRUXELLE	BE-BRU
BRUXELLES	BE-BRU
BRUXELLES CAPITALE	BE-BRU
BRUXELLESCAPITALE	BE-BRU
BRUXLESS	BE-BRU
COMMUNE DE BRUXELLES	BE-BRU
REGION BRUESSEL HAUPTSTADT	BE-BRU
REGION BRUESSELHAUPTSTADT	BE-BRU
REGION BRUSSEL HAUPTSTADT	BE-BRU
REGION BRUSSELHAUPTSTADT	BE-BRU
REGION BRUXELLES CAPITALE	BE-BRU
REGION BRUXELLESCAPITALE	BE-BRU
REGION BRUXELLOISE	BE-BRU
REGION DE BRUXELLES	BE-BRU
REGION DE BRUXELLES CAPITAL	BE-BRU
REGION DE BRUXELLES CAPITALE	BE-BRU
REGION DE BRUXELLESCAPITAL	BE-BRU
REGION DE BRUXELLESCAPITALE	BE-BRU
ZONE METROPOLITAINE DE BRUXELLES	BE-BRU

BELGIAN FLANDERS	BE-VLG
FLAMISCHE REGION	BE-VLG
FLANDER	BE-VLG
FLANDERN	BE-VLG
FLANDERS	BE-VLG
FLANDRE	BE-VLG
FLANDRE BELGE	BE-VLG
FLAUNDRES	BE-VLG
FLEMISH REGION	BE-VLG
NORTHERN BELGIUM	BE-VLG
REGION FLAMANDE	BE-VLG
VLAAMS GEWEST	BE-VLG
VLAAMSE GEWEST	BE-VLG
VLAANDER	BE-VLG
VLAANDEREN	BE-VLG
VLAANDRE	BE-VLG

REGION WALLONNE	BE-WAL
WAALS GEWEST	BE-WAL
WAALSE GEWEST	BE-WAL
WALLONIA	BE-WAL
WALLONIE	BE-WAL
WALLONIEN	BE-WAL
WALLONISCHE REGION	BE-WAL
WALLOON FEDERAL REGION	BE-WAL
WALLOON REGION	BE-WAL
WALONIE	BE-WAL