# Acre BR-AC
Ac	BR-AC
AC	BR-AC
Acre	BR-AC
Acre ?	BR-AC
Acre / Amazonas BR-AC
Acre/Amazonas	BR-AC
Acre / Mato Grosso	BR-AC
Acre State	BR-AC
Est. Acre	BR-AC
Estado do Acre	BR-AC
Territorio do Rio Branco	BR-AC
TERR. RIO BRANCO	BR-AC

# Alagoas BR-AL
Al	BR-AL
AL	BR-AL
alagoas	BR-AL
Alagoas	BR-AL
Alagoas Estado	BR-AL
Alagoas state	BR-AL
Alagoas State	BR-AL
Estado Alagoas	BR-AL
State of Alagoas	BR-AL

# Amapá BR-AP
Ampá	BR-AP
AP	BR-AP
Amap	BR-AP
[Amap	BR-AP
Amap??	BR-AP
Amap·	BR-AP
amapa	BR-AP
Amapa	BR-AP
[Amapa]	BR-AP
Amapá	BR-AP
AmapÃ¡	BR-AP
Amapá / Para	BR-AP
Amapá, Pará	BR-AP
Amapá/Pará	BR-AP
Amapa State	BR-AP
Amapa Terr.	BR-AP
Amapá (Terr.)	BR-AP
Amapá y Pará	BR-AP
Estado Amapá BR-AP
Terr. Amapa	BR-AP
 Terr. Do Amapa	BR-AP
 
# Amazonas BR-AM
Am	BR-AM
AM	BR-AM
AM?	BR-AM
Amaoznas	BR-AM
Amazona	BR-AM
Amazona	BR-AM
Amazona Estado	BR-AM
Amazona Estado.	BR-AM
amazonas	BR-AM
Amazonas	BR-AM
[Amazonas]	BR-AM
Amazonas ?	BR-AM
Amazonas?	BR-AM
Amazonas[?]	BR-AM
Amazônas	BR-AM
Amazonas/Acre	BR-AM
Amazonas (AM)	BR-AM
Amazonas / Bahia	BR-AM
Amazonas: Benjamin Constant	BR-AM
Amazonas Estado	BR-AM
Amazonas-Imaza	BR-AM
Amazonas Manaus	BR-AM
Amazonas, munic. de Uarini	BR-AM
Amazonas [Par	BR-AM
Amazonas / Para	BR-AM
Amazonas / Pará	BR-AM
Amazonas/Pará	BR-AM
Amazonas Province	BR-AM
Amazonas/Rondonia	BR-AM
Amazonas-Rondônia	BR-AM
Amazonas, Rondônia	BR-AM
Amazônas / Rondônia	BR-AM
Amazonas / Roraima	BR-AM
Amazonas/Roraima	BR-AM
Amazonas state	BR-AM
Amazonas State	BR-AM
Amazonas State (BR)	BR-AM
Amazonas - Vaupés	BR-AM
Amazonas-Vaupés	BR-AM
Amazone	BR-AM
Amazone River	BR-AM
Amazones	BR-AM
Amazone-stroomgebied	BR-AM
Amazonia	BR-AM
Amazônia	BR-AM
amazonie	BR-AM
Amazons	BR-AM
Amz BR-AM
Anaxonas BR-AM
Estado de Amazonas	BR-AM
Est Amazonas	BR-AM
Est. Amazonas	BR-AM
Est. do Amazonas	BR-AM
Estado do Amazonas	BR-AM
state of Amazonas	BR-AM
State of Amazonas	BR-AM
Territorio Federal Amazonas	BR-AM
Territorio Federal do Amazonas	BR-AM
 
# Bahia BR-BA
Ba	BR-BA
BA	BR-BA
BA/ES	BR-BA
Bah	BR-BA
BahÃ­a	BR-BA
bahia	BR-BA
Bahia	BR-BA
[Bahia ?]	BR-BA
Bahia ?	BR-BA
Bahia*	BR-BA
Bahía	BR-BA
Bahia, Brazil	BR-BA
Bahia District	BR-BA
Bahia / Espírito Santo	BR-BA
Bahia Estado	BR-BA
Bahia / Minas Gerais	BR-BA
Bahia, Nossa Shra. da Vitoria	BR-BA
Bahia / Pernambuco	BR-BA
Bahia & Piaui	BR-BA
Bahia & Rio de Janeiro	BR-BA
Bahia / São Paulo	BR-BA
Bahia state	BR-BA
Bahia State	BR-BA
Bahina	BR-BA
Baia	BR-BA
Baiha	BR-BA
BRAZIL, Bahia	BR-BA
Estado Bahia	BR-BA
Estado da Bahia	BR-BA
Estado Da Bahia	BR-BA
Estado de Bahia	BR-BA
Est Bahia	BR-BA
Est. do Bahia	BR-BA
Est. Do Bahia	BR-BA
Estado do bahia	BR-BA
State of Bahia	BR-BA
State Of Bahia	BR-BA

# Ceará BR-CE
Ce	BR-CE
CE	BR-CE
Cear	BR-CE
Cear·	BR-CE
Ceara	BR-CE
Céara	BR-CE
Ceará	BR-CE
Ceará ?	BR-CE
Cearà	BR-CE
CearÃ¡	BR-CE
Ceara District	BR-CE
Ceara Estado	BR-CE
Ceará Estado	BR-CE
Ceará / Minas Gerais	BR-CE
Ceara Mirim	BR-CE
Ceara State	BR-CE
Ceara (State)	BR-CE
Fortaleza	BR-CE
Fortaleza Ceará	BR-CE
Estado do Ceara	BR-CE
State of Ceara	BR-CE

# Distrito Federal BR-DF
Df	BR-DF
DF	BR-DF
D.F.	BR-DF
Dist. Fed. (DF)	BR-DF
Dist. Federal	BR-DF
Disto Federal	BR-DF
District Fed.	BR-DF
District Federal	BR-DF
Districto Federal	BR-DF
Distrito Federa	BR-DF
Distrito federal	BR-DF
Distrito Federal	BR-DF
Distrito Federál	BR-DF
Distrito Federal (BR)	BR-DF
Distrito Federal/Goias	BR-DF
Distrito Federal / Goiás	BR-DF
Distrito Federal/Goi?s	BR-DF
Dsto. Federal	BR-DF
Brasilia	BR-DF
Brasília	BR-DF
BrasÌlia	BR-DF
Brasilia DF	BR-DF
Brasilia D. F.	BR-DF
Brasília - Distrito Federal	BR-DF
Brasília Distrito Federal	BR-DF
Brasília, Dsto. Federal	BR-DF
BRASILIA PROV.	BR-DF
BRAZIL, Distrito Federal	BR-DF
Brazilian Federal District	BR-DF
Federal Dist	BR-DF
Federal Dist.	BR-DF
Federal District	BR-DF
Federal District, Brasilia	BR-DF
 
# Espírito Santo BR-ES
Epírito Santo	BR-ES
Es	BR-ES
ES	BR-ES
EspÃ­rito Santo	BR-ES
Esirito Santo	BR-ES
Esperito santo	BR-ES
Esperito Santo	BR-ES
Espirito, off Guarapari	BR-ES
Espirito Paulo	BR-ES
Espirito Santao	BR-ES
espirito Santo	BR-ES
Espirito santo	BR-ES
[Espirito Santo]	BR-ES
Espirito Santo	BR-ES
Espirito Santo ?	BR-ES
Espírito santo	BR-ES
Espírito Santo	BR-ES
EspÌrito Santo	BR-ES
Espiríto Santo	BR-ES
Espirito Santo Estado	BR-ES
Espirito Santo - Minas Gerais	BR-ES
Espirito Santos	BR-ES
Espirito Santo State	BR-ES
Espiritu Santo	BR-ES
Espíritu Santo	BR-ES
EspÌritu Santo	BR-ES
Espiritu Santo Id.	BR-ES
Espiritu Santos	BR-ES
Espiru De Santo	BR-ES
Esp¡rito Santo	BR-ES
Esp�rito Santo	BR-ES
Esp. Santo	BR-ES
Estado do Espirito Santo	BR-ES
Spirito Santo	BR-ES
State of Espirito Santo	BR-ES

# Goiás BR-GO
Estado de Goias	BR-GO
Estado De Goias	BR-GO
Estado de Goías	BR-GO
Estado de Goiás	BR-GO
Estado de Goiá¡s	BR-GO
Est. do Goias	BR-GO
Gaias	BR-GO
Ggoiás	BR-GO
Go	BR-GO
GO	BR-GO
Goais	BR-GO
Goayz	BR-GO
Goi	BR-GO
[Goi	BR-GO
Goi&#225s	BR-GO
Goiania	BR-GO
goias	BR-GO
Goias	BR-GO
Goiás	BR-GO
Goiás ?	BR-GO
GoiÃ¡s	BR-GO
Goiás (GO)	BR-GO
Goias/Maranhao/Para	BR-GO
Goiás / Mato Grosso / Pará / Rondônia	BR-GO
Goias / Minas Gerais	BR-GO
Goiás / Minas Gerais	BR-GO
Goiás / Minas Gerais / Para	BR-GO
Goiás/Pará	BR-GO
GOIAS, SANTA ISABEL	BR-GO
Goias State	BR-GO
Goias [Tocantins]	BR-GO
Goiás [Tocantins]	BR-GO
Goiás/Tocantins	BR-GO
Goiaz	BR-GO
Goi s	BR-GO
Goi-s	BR-GO
Goi·s	BR-GO
Goi�s	BR-GO
state of Goias	BR-GO
 State of Goias	BR-GO
 State of Goiás	BR-GO
 
# Maranhão BR-MA
Maranh	BR-MA
Maranhâ\u0080¹o	BR-MA
maranhao	BR-MA
Maranhao	BR-MA
Maranhäo	BR-MA
Maranhão	BR-MA
MaranhÃ£o	BR-MA
Maranhaõ	BR-MA
Maranhao and Para	BR-MA
Maranhao (Para-Maranhao)	BR-MA
Maranhao/Piaui	BR-MA
Maranhão, São Paulo	BR-MA
Maranhao State	BR-MA
Maranh-o	BR-MA
Maranh„o	BR-MA
Est. do Maranhao	BR-MA
State of Maranaho	BR-MA
State of Maranhao	BR-MA
State of Maranhão	BR-MA
 
# Mato Grosso BR-MT
BRAZIL, Mato Grosso State	BR-MT
Maro Grosso	BR-MT
Mata Grosso	BR-MT
Mato Crasso	BR-MT
Mato Gorsso	BR-MT
Mato Grasso	BR-MT
Mato Grosse	BR-MT
mato grosso	BR-MT
Matogrosso	BR-MT
Mato grosso	BR-MT
[Mato Grosso]	BR-MT
Mato Grosso	BR-MT
Mato Grosso ?	BR-MT
Mato Grosso.	BR-MT
Mato Grosso do Norte	BR-MT
Mato Grosso / Minas Gerais	BR-MT
Mato Grosso/Minas Gerais	BR-MT
Mato Grosso / Pará	BR-MT
Mato Grosso / Rondônia	BR-MT
Mato Grosso State	BR-MT
Matto Grasso	BR-MT
Matto Groso	BR-MT
Matto grosso	BR-MT
Matto Grosso	BR-MT
Matto Grosso State	BR-MT
Estado de Mato Grosso	BR-MT
Est. do Mato Grosso	BR-MT
Est. Do Mato Grosso	BR-MT
Est Mato Grosso	BR-MT
Est. Mato Grosso	BR-MT
Mt	BR-MT
MT	BR-MT
M.T.	BR-MT
Mtg	BR-MT
Rato Grosso	BR-MT
State of Mato Grosso	BR-MT
 
# Matro Grosso do Sul BR-MS
Mato Graso do Sul	BR-MS
Mato Grosso del Sur	BR-MS
Mato grosso do sul	BR-MS
Mato Grosso [do Sul]	BR-MS
Mato Grosso do Sul	BR-MS
Mato Grosso do Sul ?	BR-MS
Mato Grosso do Sul.	BR-MS
Mato Grosso Do Sul	BR-MS
Mato Grosso do Sul / São Paulo	BR-MS
Mato Grosso do Sul State	BR-MS
Mato Grosso Do Sul State	BR-MS
Mato Grosso so Sul State	BR-MS
mato grosso sud	BR-MS
Mato Grosso Sul State	BR-MS
Matos Grosso do Sul	BR-MS
Matto Grasso do Sul	BR-MS
Matto Grosso do Sul	BR-MS
Ms	BR-MS
MS	BR-MS
Mts	BR-MS
State of Mato Grosso Do SuI	BR-MS
State of Mato Gros So Do SuI	BR-MS
State of Mato Grosso do Sul	BR-MS
State of Mato Grosso Do Sul	BR-MS
 
# Minas Gerais BR-MG
Menas Gerais	BR-MG
E Minas Gerais	BR-MG
Estado de Minas Gerais	BR-MG
Est. do Minas Gerais	BR-MG
Mg	BR-MG
MG	BR-MG
M. Geraes	BR-MG
MG/ES	BR-MG
Mina Geraes	BR-MG
Mina Gerais	BR-MG
Minais gerais	BR-MG
Minais Gerais	BR-MG
Minas	BR-MG
minas geraes	BR-MG
Minas Geraes	BR-MG
Minas Geräes	BR-MG
Minas Geraeus	BR-MG
minas Gerais	BR-MG
Minas gerais	BR-MG
[Minas Gerais]	BR-MG
Minas Gerais	BR-MG
Minas Gerais ?	BR-MG
MInas Gerais	BR-MG
Minas Gerais-Bahia	BR-MG
Minas Gerais Estado	BR-MG
Minas Gerais (MG)	BR-MG
Minas Gerais / Rio de Janeiro	BR-MG
Minas Gerais; Rio de Janeiro	BR-MG
Minas Gerais / Sao Paulo	BR-MG
Minas Gerais State	BR-MG
Minas Gerias	BR-MG
Minas Minas Gerais	BR-MG
Mines Gerais	BR-MG
state of Minas Gerais	BR-MG
State of Minas Gerais	BR-MG
 
# Pará BR-PA
Pa	BR-PA
PA	BR-PA
Par-	BR-PA
Par??	BR-PA
Par·	BR-PA
Par�	BR-PA
para	BR-PA
Para	BR-PA
Para ?	BR-PA
Pára	BR-PA
pará	BR-PA
Pará	BR-PA
[ParÃ¡]	BR-PA
ParÃ¡	BR-PA
Pará-Acre	BR-PA
Pará/Amapá	BR-PA
Pará bx/ Amazonas	BR-PA
Para District	BR-PA
Para Estado	BR-PA
Pará Estado	BR-PA
ParÃ¡/Maranhao	BR-PA
Pará (PA)	BR-PA
Pará/Piauí	BR-PA
ParÃ¡, SÃ£o Felix do Xingu	BR-PA
Para State	BR-PA
Para States	BR-PA
Para/Tocantins?	BR-PA
Par?? State	BR-PA
Estado de Para	BR-PA
Estado do Para	BR-PA
Estados Para	BR-PA
Est. do Pará	BR-PA
Est ParÃ¡	BR-PA
State of Par??	BR-PA
State of Para	BR-PA
 
# Paraíba BR-PB
Parahyba	BR-PB
Parahyba (= Paraiba)	BR-PB
paraiba	BR-PB
Paraiba	BR-PB
Paraiba ?	BR-PB
Paraíba	BR-PB
ParaÌba	BR-PB
Paraiba do Norte	BR-PB
Parahyba Do Norte	BR-PB
Paraiba State	BR-PB
Paralba	BR-PB
Pb	BR-PB
PB	BR-PB
Est. do Paraíba	BR-PB

# Paraná BR-PR
Paran	BR-PR
Paran-	BR-PR
Paran? [?]	BR-PR
Paran·	BR-PR
Paran�	BR-PR
parana	BR-PR
Parana	BR-PR
Parana?	BR-PR
Paraná	BR-PR
ParanÃ¡	BR-PR
Paraná (23°16'S-50°04W)	BR-PR
Paraná (23.16S-50.04W)	BR-PR
Parana Coast	BR-PR
Parana Estado	BR-PR
Parana Province	BR-PR
Paraná / Sao Paulo	BR-PR
Paraná / São Paulo	BR-PR
Parana state	BR-PR
Parana State	BR-PR
Paraná State	BR-PR
Parand	BR-PR
Paranß	BR-PR
E Parana	BR-PR
Estado do Parana	BR-PR
Estado de Paraná	BR-PR
Pr	BR-PR
PR	BR-PR
PR?	BR-PR
PROV. PARANA	BR-PR
Est. do Paraná	BR-PR
state of Parana	BR-PR
State of Paraná	BR-PR
 
# Pernambuco BR-PE
Pe	BR-PE
PE	BR-PE
Penambuco	BR-PE
Per	BR-PE
Permanbuco	BR-PE
Pernambuca	BR-PE
Pernambuca Estado	BR-PE
pernambuco	BR-PE
Pernambuco	BR-PE
Pernambuco ?	BR-PE
Pernambuco Estado	BR-PE
Pernambuco State	BR-PE
Pernanbuco	BR-PE
Pernanbuco State	BR-PE
Pernembuco Estado	BR-PE
Estado de Pernambuco	BR-PE
Est. do Pernambuco	BR-PE
Estado Pernambuco	BR-PE
Recife	BR-PE
Recife,	BR-PE
State of Pernambuco	BR-PE

# Piauí BR-PI
PI	BR-PI
Piau	BR-PI
PiauÃ	BR-PI­
Piauby	BR-PI
Piauhí	BR-PI
Piauhy	BR-PI
piaui	BR-PI
Piaui	BR-PI
Piauí	BR-PI
PiauÌ	BR-PI
Piauí-Goias	BR-PI
Piauí (Piauhy)	BR-PI
Piauí / Santa Catarina	BR-PI
Piaui State	BR-PI
Estado do Piaui	BR-PI
Est. do Piauí	BR-PI
state of Piaui	BR-PI
State of Piaui	BR-PI
State of Piauí	BR-PI

# Rio de Janeiro BR-RJ
Estado de Rio de Janeiro	BR-RJ
Estado de Río de Janeiro	BR-RJ
Estado de R�o de Janeiro	BR-RJ
Estado do Rio	BR-RJ
Estado Do Rio	BR-RJ
Estado do Rio de Janeiro	BR-RJ
Estado do Rio de Janiero	BR-RJ
RÃ­o de Janeiro	BR-RJ
Estado Rio de Janeiro	BR-RJ
Estado Río de Janeiro	BR-RJ
Estado Rio de Janiero	BR-RJ
Est. do Rio	BR-RJ
Est. Do Rio	BR-RJ
Est. do Rio de Janeiro	BR-RJ
Est. Do Rio de Janeiro	BR-RJ
Rio de Janeira	BR-RJ
rio de janeiro	BR-RJ
Rio de janeiro	BR-RJ
(Rio de Janeiro)	BR-RJ
[Rio de Janeiro- *	BR-RJ
[Rio de Janeiro]	BR-RJ
Rio [de Janeiro]	BR-RJ
Rio de Janeiro	BR-RJ
Rio de Janeiro :	BR-RJ
Rio de Janeiro?	BR-RJ
Rio De Janeiro	BR-RJ
Río de Janeiro	BR-RJ
Rio de Janeiro-Belem	BR-RJ
Rio De Janeiro Estado	BR-RJ
Río de Janeiro/Minas Gerais	BR-RJ
Rio de Janeiro province	BR-RJ
Rio de Janeiro (RJ	BR-RJ
Rio de Janeiro (RJ)	BR-RJ
Rio de Janeiro / Sao Paulo	BR-RJ
Rio de Janeiro-Sao Paulo	BR-RJ
Rio de Janeiro/Sao Paulo	BR-RJ
Rio de Janeiro / São Paulo	BR-RJ
[Rio de Janeiro-Sao Paulo-Minas Gerais border area]	BR-RJ
Rio de Janeiro State	BR-RJ
Rio De Janeiro State	BR-RJ
Rio de Janeiro State, Guanabara Bay	BR-RJ
Rio de Janerio	BR-RJ
Rio de janero state	BR-RJ
Rio de Janiero	BR-RJ
Rio De Janiero	BR-RJ
Rio De Janiero Estado	BR-RJ
Rio de Janiero State	BR-RJ
Rio Estado	BR-RJ
Rio Janeiro	BR-RJ
Rio Janeir. Prov.	BR-RJ
Rio ou RJ	BR-RJ
Rj	BR-RJ
RJ	BR-RJ
R.J.	BR-RJ
RJ?	BR-RJ
RJ/MG	BR-RJ
RJ ou SP?	BR-RJ
RJ? ou SP?	BR-RJ
RJ/SP	BR-RJ
State of Rio de Janeiro	BR-RJ
State Rio de Janeiro	BR-RJ

# Rio Grande do Sul BR-RS
Estado do Rio Grande do Sul	BR-RS
Estado de Río Grande do Sul	BR-RS
Estado Rio Grande Do Sul	BR-RS
Porto alegre	BR-RS
Porto Alegre	BR-RS
Porto Allegre	BR-RS
Prov. Rio Grande Do Sul	BR-RS
Est. do Rio Grande do Sul	BR-RS
r.grande do sul	BR-RS
Rgs	BR-RS
Rio de Grande do Sul	BR-RS
Rio Gande do Sul	BR-RS
Rio G. do Sul	BR-RS
Rio Grabde do Sol	BR-RS
Rio Grand do Sul	BR-RS
Rio Grande del Sol	BR-RS
Rio Grande del Sur	BR-RS
Rio Grande Del Sur	BR-RS
Río Grande del Sur	BR-RS
Rio Grande de Sol	BR-RS
Rio Grande de Sul	BR-RS
Rio Grande de Sur Province	BR-RS
Rio Grande di Sul	BR-RS
Rio Grande do S	BR-RS
Rio grande do sol	BR-RS
Rio Grande do Sol	BR-RS
Rio Grande Do Sol	BR-RS
Rio Grande do Sol State	BR-RS
Rio Grande do Soul	BR-RS
Rio Grande do sud	BR-RS
Rio grande do sul	BR-RS
Rio grande do Sul	BR-RS
Rio Grande do sul	BR-RS
[Rio Grande do Sul]	BR-RS
Rio Grande do Sul	BR-RS
Rio Grande do Sul ?	BR-RS
Rio Grande do Sul?	BR-RS
RioGrande do Sul	BR-RS
Rio Grande Do Sul	BR-RS
Rio Grande Do Sul ?	BR-RS
Rio Grande Do Sul?	BR-RS
Río grande do sul	BR-RS
Río Grande do sul	BR-RS
Río Grande do Sul	BR-RS
Rio Grande do Sul (RS)	BR-RS
Rio Grande do Sul / Santa Catarina	BR-RS
Rio Grande Do Sul / Sao Paulo	BR-RS
Rio Grande do Sul State	BR-RS
Rio Grande Do Sul State	BR-RS
Rio Grande do Sur	BR-RS
Río Grande do Sur	BR-RS
rio grande du sud	BR-RS
Rio Grande Sol	BR-RS
Rio Grande Sul	BR-RS
Rio Grando do Sul	BR-RS
Rs	BR-RS
R s	BR-RS
RS	BR-RS

# Rio Grande do Norte BR-RN 
RN	BR-RN
R. Norte Do Grande	BR-RN
Estado Rio Grande do Norte	BR-RN
Estado Rio Grande Do Norte	BR-RN
Rgn	BR-RN
R.Grande Norte State	BR-RN
R.Grande N. State	BR-RN
Rio Grande del Norte	BR-RN
Rio Grande de Norte	BR-RN
Rio Grande De Norte	BR-RN
Rio Grande do Horte	BR-RN
Rio Grande do nNrte	BR-RN
Rio grande do norte	BR-RN
Rio grande do Norte	BR-RN
Rio Grande do Norte	BR-RN
Rio Grande Do Norte	BR-RN
Rio GRande do Norte	BR-RN
Río Grande do Norte	BR-RN
Rio Grande do Norte District	BR-RN
Rio Grande do Norte State	BR-RN
Rio Grande do Norte (State)	BR-RN
Rio Grande Do Norte State	BR-RN
Rio Grande Nord	BR-RN
Rio Grande Norte	BR-RN

# São Paulo BR-SP 
BRAZIL, Sao Paulo State	BR-SP
E Sao Paulo	BR-SP
PROV. SAO PAULO	BR-SP
PROV. SÃO PAULO	BR-SP
Prov. St. Paul	BR-SP
Estado de Sao Paulo	BR-SP
Estado de São Paulo	BR-SP
Estado Sao Paulo	BR-SP
Est. do Sao Paulo	BR-SP
Est. Do Sao Paulo	BR-SP
S&#227;o Paulo	BR-SP
Sao Paolo	BR-SP
São Paolo	BR-SP
Sao Paolo State	BR-SP
São Paráulo	BR-SP
Sao Pauco	BR-SP
sao paulo	BR-SP
Sao paulo	BR-SP
[Sao Paulo]	BR-SP
Sao Paulo	BR-SP
Sao - Paulo	BR-SP
Sao Paulo ?	BR-SP
Sao Paulo (?)	BR-SP
Sao Paulo *	BR-SP
Sâo Paulo	BR-SP
SÂ\u008Bo Paulo	BR-SP
Säo Paulo	BR-SP
São paulo	BR-SP
São Paulo	BR-SP
São Paulo ?	BR-SP
SãO Paulo	BR-SP
SÃ£o Paulo	BR-SP
SÃO Paulo	BR-SP
Sāo Paulo	BR-SP
Saó Paulo	BR-SP
Saõ Paulo	BR-SP
Sao Paulo Estado.	BR-SP
São Paulo Estado	BR-SP
Sao Paulo, Litoral Sul	BR-SP
Sao Paulo Province	BR-SP
Sao Paulo State	BR-SP
São PauloState	BR-SP
Sau Paolo	BR-SP 
Sau Paulo	BR-SP 
S„o Paulo	BR-SP 
S�o Paulo	BR-SP 
S�o Paulo*	BR-SP 
S�o Paulo state	BR-SP 
Sp	BR-SP 
SP	BR-SP 
SP?	BR-SP 
S. Paulo	BR-SP 
State of sao paulo	BR-SP 
State of Sao Paulo	BR-SP 
State of São Paulo	BR-SP 
SùO Paulo	BR-SP 
SÿO Paulo	BR-SP 

# Santa Catarina BR-SC
Sc	BR-SC
SC	BR-SC
SC?	BR-SC
S. Cararina	BR-SC
S. Catarina	BR-SC
S.Cat.State	BR-SC
S.C.Brazil	BR-SC
Estado de Santa Catarina	BR-SC
Estado de Sta. Catarina	BR-SC
Estado Santa Catarina	BR-SC
Est. do Santa Catarina	BR-SC
Santa Cantarina	BR-SC
Santa Catairna	BR-SC
Santa Catalina	BR-SC
santa catarina	BR-SC
Santa catarina	BR-SC
Santa Catarina	BR-SC
Santa Catarina ?	BR-SC
Santa Catarina (Catharina)	BR-SC
Santa Catarina Prov.	BR-SC
Santa Catarina Province	BR-SC
Santa catarina state	BR-SC
Santa Catarina State	BR-SC
Santa Caterida	BR-SC
Santa Caterina	BR-SC
Santa Caterina, District Jaraguá	BR-SC
Santa catharina	BR-SC
Santa Catharina	BR-SC
Santa Catherina	BR-SC
Sta. Cat.	BR-SC
Sta Catarina	BR-SC
Sta. Catarina	BR-SC
Sta. Catharina	BR-SC
St Catarina	BR-SC
St. Catharina	BR-SC
St Catherinae	BR-SC
Est. Santa Catharina	BR-SC

# Rondônia BR-RO
Ro	BR-RO
R o	BR-RO
RO 	BR-RO
Est. do Rondônia	BR-RO
Rond	BR-RO
RondÃ´nia	BR-RO
Rond-nia	BR-RO
Rondonia	BR-RO
Rondônia	BR-RO
Rondônia ?	BR-RO
Rondoniai	BR-RO
Rôndonia/Mato Grosso	BR-RO
Rondonia Province	BR-RO
Rondonia State	BR-RO
Rondonia terr.	BR-RO
Rondonia (Terr.)	BR-RO
RondÙnia	BR-RO
State of Rondônia	BR-RO
Territorio de Guapore [now Estado de Rondonia]	BR-RO

# Sergipe BR-SE
SE	BR-SE
SE Brazil 	BR-SE
Ser	BR-SE
sergipe	BR-SE
Sergipe	BR-SE

# Roraima BR-RR
RR	BR-RR
Rora	BR-RR
Roraia	BR-RR
roraima	BR-RR
Roraima	BR-RR
[Roraima]	BR-RR
Roraima ?	BR-RR
Roraima;Amazonas	BR-RR
Roraima (Terr.)	BR-RR
Terr. Roraima	BR-RR
Terr. Roraima (RR)	BR-RR

# Tocantins BR-TO
Est. do Tocantins	BR-TO
Estado do Tocantins	BR-TO
State of Tocantins	BR-TO
To	BR-TO
TO	BR-TO
tocantins	BR-TO
Tocantins	BR-TO
[Tocantins]	BR-TO
Tocantins/Goiás	BR-TO
Tocatins	BR-TO
Toncantins	BR-TOq