ALBERTA	CA-AB
AB	CA-AB
BRITISH COLUMBIA	CA-BC
BRITISH COLUMBI	CA-BC
BC	CA-BC
MANITOBA	CA-MB
MB	CA-MB
NEW BRUNSWICK	CA-NB
NEW-BRUNSWICK	CA-NB
NOUVEAU-BRUNSWICK	CA-NB
NOUVEAU BRUNSWICK	CA-NB
NB	CA-NB
NEWFOUNDLAND AND LABRADOR	CA-NL
LABRADOR	CA-NL
NEWFOUNDLAND	CA-NL
NEWFOUNLAND	CA-NL
NEWFOUNDLAND & LABRADOR	CA-NL
NEWFOUNDLAND/LABRADOR	CA-NL
TERRE-NEUVE & LABRADOR	CA-NL
TERRE-NEUVE	CA-NL
TERRE NEUVE	CA-NL
NL	CA-NL
NOVA SCOTIA	CA-NS
NS	CA-NS
ONTARIO	CA-ON
ONTARIIO	CA-ON
ON	CA-ON
PRINCE EDWARD ISLAND	CA-PE
PE	CA-PE
PEI	CA-PE
QUEBEC	CA-QC
QUEBEQ	CA-QC
QUE	CA-QC
QUÃ‰	CA-QC
QC	CA-QC
SASKATCHEWAN	CA-SK
SAKATCHEWAN	CA-SK
SK	CA-SK
NORTHWEST TERRITORIES	CA-NT
NORTHWES TERRITORIES	CA-NT
THE NORTHWEST TERRITORIES	CA-NT
NOTHWEST TERRITORIES	CA-NT
NORTH WEST TERRITORIES	CA-NT
NORTHWWEST TERRITORIES	CA-NT
NORTHWEST TERRITIORIES	CA-NT
NT	CA-NT
NUNAVUT	CA-NU
NU	CA-NU
YUKON	CA-YT
YUKON TERRITORY	CA-YT
YT	CA-YT