DISTRITO CAPITAL DE BOGOTA 	CO-DC
BOGOTA DC 	CO-DC
BOGOTA D C 	CO-DC
BOGOTA 	CO-DC
SANTAFE DE BOGOTA 	CO-DC
BOGOTA DISTRITO CAPITAL 	CO-DC
AMAZONAS 	CO-AMA
ANTIOQUIA 	CO-ANT
ARAUCA 	CO-ARA
ATLANTICO 	CO-ATL
BOLIVAR 	CO-BOL
BOYACA 	CO-BOY
CALDAS 	CO-CAL
CAQUETA 	CO-CAQ
CASANARE 	CO-CAS
CAUCA 	CO-CAU
CESAR 	CO-CES
CORDOBA 	CO-COR
CUNDINAMARCA 	CO-CUN
CHOCO 	CO-CHO
GUAINIA 	CO-GUA
GUAVIARE 	CO-GUV
HUILA 	CO-HUI
LA GUAJIRA 	CO-LAG
GUAJIRA 	CO-LAG
MAGDALENA 	CO-MAG
META 	CO-MET
NARIÃ‘O 	CO-NAR
NARINO 	CO-NAR
NORTE DE SANTANDER 	CO-NSA
PUTUMAYO 	CO-PUT
QUINDIO 	CO-QUI
RISARALDA 	CO-RIS
SAN ANDRES Y PROVIDENCIA 	CO-SAP
ARCHIPIELAGO DE SAN ANDRES PROVIDENCIA Y SANTA CATALINA 	CO-SAP
SAN ANDRES PROVIDENCIA Y SANTA CATALINA 	CO-SAP
SANTANDER 	CO-SAN
SUCRE 	CO-SUC
TOLIMA 	CO-TOL
VALLE DEL CAUCA 	CO-VAC
VALLE 	CO-VAC
VAUPES 	CO-VAU
VICHADA 	CO-VID